AAAAAAAAAAAAAAAAAAAAAAAAAAAA
APPPPPPPPPPPPAAAAAAAAAAAAAAA
APGGGGGGGGGGPAAAAAAAAAAAAAAA
APGGGGGGGGGGPAAAAAAAAAAAAAAA
APGGGGGGGGGGPAAAAAAAAAAAAAAA
APGGGGGGGGGGPAAAAAAAAAAAAAAA
APGGGGGGGGGGPAAAAAAAAAAAAAAA
APGGGGGGGGGGPAAAAAAAAAAAAAAA
APPPPPPPPPPPPAAAAAAAAAAAAAAA
AAAAAAAAAAAAAAAAAAAAAAAAAAAA
AAAAAAAAAAAAAAAAAAAAAAAAAAAA
APPPPPPPPPPPPAAAAAAAAAAAAAAA
APGGGGGGGGGGPAAAAAAAAAAAAAAA
APGGGGGGGGGGPAAAAAAAAAAAAAAA
APGGGGGGGGGGPAAAAAAAAAAAAAAA
APGGGGGGGGGGPAAAAAAAAAAAAAAA
APGGGGGGGGGGPAAAAAAAAAAAAAAA
APGGGGGGGGGGPAAAAAAAAAAAAAAA
APPPPPPPPPPPPAAAAAAAAAAAAAAA
AAAAAAAAAAAAAAAAAAAAAAAAAAAA